5 10
|--------|
|..@P...P|
|.----F|.|
|...F..|.|
|--------|
